11111111111
100P0110001
10EC0111111
10000011111
11111111111
10000011111
10000011111
11111111111
