11111111111
10000110001
10EC0111111
10000011111
11111111111
10000011111
10000011111
11111111111
